************
*          *
* *        *
*  *       *
*   *      *
*    *     *
*     *    *
*      *   *
*       *  *
*        * *
*          *
************